允许/禁止交易	@允许交易
允许/禁止加入行会	@允许加入门派
退出当前行会	@退出门派
允许/禁止行会聊天	@允许行会聊天
允许/禁止行会联盟	@允许联盟
允许/禁止记忆传送	@允许天地合一
记忆传送	@天地合一
允许/禁止行会传送	@允许行会合一
行会传送	@行会合一
允许/拒绝组队聊天	@拒绝组队聊天
允许/拒绝指定人物私聊	@拒绝
允许/拒绝所有私聊	@拒绝私聊
查询夫妻位置	@查询伴侣
夫妻传送	@夫妻传送
允许/拒绝夫妻传送	@允许夫妻传送
查询师徒位置	@查询师徒
师徒传送	@师徒传送
允许/拒绝师徒传送	@允许师徒传送
上马/骑马	@骑马
下马	@下马
允许/禁止邀请上马	@禁止邀请上马
仓库开锁	@仓库开锁
锁定仓库	@锁定仓库
设置仓库密码	@设置密码
修改仓库密码	@修改密码
清除仓库密码	@清除密码
解开登陆锁	@开锁
启用/关闭登陆锁	@锁定
